000000000000000000000000000-
000000000000000000000000000-
000000007000000000000000000-
000001666664000000007700000-
000005000005700000016640000-
000075000005000000050050000-
007005000005700000050026669-
086663000002666400050000000-
000000000000000500050000000-
000000000000000570050000000-
000000000000000266630000000-
000000000000000000000000000-
000000000000000000000000000-
000000000000000000000000000-
000000000000000000000000000